Level 1
Flower
4,0,5:51,173,38
4,1,5:51,173,38
4,2,5:51,173,38
4,3,4:51,173,38
4,3,5:51,173,38
4,4,3:51,173,38
4,4,5:51,173,38
4,5,5:51,173,38
4,6,4:255,239,12
4,6,5:255,239,12
4,6,6:255,239,12
4,7,3:255,239,12
4,7,4:255,239,12
4,7,5:241,241,241
4,7,6:255,239,12
4,7,7:255,239,12
4,8,4:255,239,12
4,8,5:255,239,12
4,8,6:255,239,12
4,9,5:255,239,12
-
0,0,0,0,0,0,0,0,0,0
0,0,0,0,0,0,0,0,0,0
0,0,0,0,0,0,0,0,0,0
0,0,0,0,0,0,0,0,0,0
1,1,1,2,2,1,3,5,3,1
0,0,0,0,0,0,0,0,0,0
0,0,0,0,0,0,0,0,0,0
0,0,0,0,0,0,0,0,0,0
0,0,0,0,0,0,0,0,0,0
0,0,0,0,0,0,0,0,0,0
-
0,0,0,0,0,0,0,0,0,0
0,0,0,0,0,0,0,0,0,0
0,0,0,0,0,0,0,0,0,0
0,0,0,0,0,0,0,0,0,0
0,0,0,2,4,10,3,1,0,0
0,0,0,0,0,0,0,0,0,0
0,0,0,0,0,0,0,0,0,0
0,0,0,0,0,0,0,0,0,0
0,0,0,0,0,0,0,0,0,0
0,0,0,0,0,0,0,0,0,0
-
0,0,0,0,0,1,0,0,0,0
0,0,0,0,0,1,0,0,0,0
0,0,0,0,0,1,0,0,0,0
0,0,0,0,1,1,0,0,0,0
0,0,0,1,0,1,0,0,0,0
0,0,0,0,0,1,0,0,0,0
0,0,0,0,1,1,1,0,0,0
0,0,0,1,1,1,1,1,0,0
0,0,0,0,1,1,1,0,0,0
0,0,0,0,0,1,0,0,0,0
-