Level 3
Dog
4,3,3:198,149,1
4,3,5:198,149,1
4,5,3:198,149,1
4,5,5:198,149,1
4,6,3:198,149,1
4,6,5:198,149,1
5,3,3:198,149,1
5,3,4:198,149,1
5,3,5:198,149,1
5,4,3:198,149,1
5,4,4:198,149,1
5,4,5:198,149,1
5,5,3:198,149,1
5,5,5:198,149,1
6,3,3:198,149,1
6,5,3:198,149,1
6,5,4:198,149,1
6,5,5:198,149,1
6,6,3:198,149,1
6,6,4:198,149,1
6,6,5:198,149,1
6,7,3:255,229,88
6,7,4:255,229,88
6,7,5:255,229,88
7,5,3:198,149,1
7,5,4:198,149,1
7,5,5:198,149,1
7,6,3:198,149,1
7,6,4:198,149,1
7,6,5:198,149,1
8,5,3:186,148,8
8,5,5:198,149,1
-
0,0,0,0,0,0,0,0,0,0
0,0,0,0,0,0,0,0,0,0
0,0,0,0,0,0,0,0,0,0
0,0,0,0,0,0,0,0,0,0
0,0,0,2,0,2,2,0,0,0
0,0,0,3,3,2,0,0,0,0
0,0,0,1,0,3,3,3,0,0
0,0,0,0,0,3,3,0,0,0
0,0,0,0,0,2,0,0,0,0
0,0,0,0,0,0,0,0,0,0
-
0,0,0,0,0,0,0,0,0,0
0,0,0,0,0,0,0,0,0,0
0,0,0,0,0,0,0,0,0,0
0,0,0,0,0,0,0,0,0,0
0,0,0,3,0,3,0,0,0,0
0,0,0,3,2,3,0,0,0,0
0,0,0,4,3,3,0,0,0,0
0,0,0,2,2,2,0,0,0,0
0,0,0,1,0,1,0,0,0,0
0,0,0,0,0,0,0,0,0,0
-
0,0,0,0,0,0,0,0,0,0
0,0,0,0,0,0,0,0,0,0
0,0,0,0,0,0,0,0,0,0
0,0,0,3,1,2,0,0,0,0
0,0,0,1,1,1,0,0,0,0
0,0,0,5,2,5,0,0,0,0
0,0,0,3,2,3,0,0,0,0
0,0,0,1,1,1,0,0,0,0
0,0,0,0,0,0,0,0,0,0
0,0,0,0,0,0,0,0,0,0
-