Level 2
Airplane
1,5,6:255,255,0
2,5,6:255,255,0
3,5,2:255,255,0
3,5,6:255,255,0
4,5,2:253,253,1
4,5,3:253,253,1
4,5,4:253,253,1
4,5,5:253,253,1
4,5,6:253,253,1
4,5,7:253,253,1
4,5,8:255,255,255
4,6,2:255,255,0
4,6,6:23,198,184
4,6,7:23,198,184
5,5,2:255,255,0
5,5,6:255,255,0
6,5,6:255,255,0
7,5,6:255,255,0
-
0,0,0,0,0,0,0,0,0,0
0,0,0,0,0,1,0,0,0,0
0,0,0,0,0,1,0,0,0,0
0,0,0,0,0,2,0,0,0,0
0,0,0,0,0,7,3,0,0,0
0,0,0,0,0,2,0,0,0,0
0,0,0,0,0,1,0,0,0,0
0,0,0,0,0,1,0,0,0,0
0,0,0,0,0,0,0,0,0,0
0,0,0,0,0,0,0,0,0,0
-
0,0,0,0,0,0,0,0,0,0
0,0,0,0,0,0,1,0,0,0
0,0,0,0,0,0,1,0,0,0
0,0,1,0,0,0,1,0,0,0
0,0,2,1,1,1,2,2,1,0
0,0,1,0,0,0,1,0,0,0
0,0,0,0,0,0,1,0,0,0
0,0,0,0,0,0,1,0,0,0
0,0,0,0,0,0,0,0,0,0
0,0,0,0,0,0,0,0,0,0
-
0,0,0,0,0,0,0,0,0,0
0,0,0,0,0,0,0,0,0,0
0,0,0,0,0,0,0,0,0,0
0,0,0,0,0,0,0,0,0,0
0,0,0,0,0,0,0,0,0,0
0,0,3,1,1,1,7,1,1,0
0,0,1,0,0,0,1,1,0,0
0,0,0,0,0,0,0,0,0,0
0,0,0,0,0,0,0,0,0,0
0,0,0,0,0,0,0,0,0,0
-